0 0 0 1 1 1 2 2 2 
0 0 0 1 1 1 1 2 2 
0 3 0 4 4 1 2 2 2 
3 3 0 4 4 1 2 5 5 
3 3 3 3 4 5 5 5 5 
3 3 6 7 4 4 8 5 5 
6 6 6 7 4 4 8 5 8 
6 6 7 7 7 7 8 8 8 
6 6 6 7 7 7 8 8 8 
